12
1,5,7,6,1,4,1,7,7,5,7,4
3,5,12,11,5,5,7,15,13,7,14,2
9,7,7,15,6,1,13,13,4,9,13,14
0,10,8,9,14,3,5,6,3,4,2,10
2,10,0,3,12,9,5,12,9,6,8,10
10,11,4,8,2,3,6,2,3,15,5,14
11,12,2,3,12,11,14,9,12,9,4,10
11,6,9,13,6,10,8,0,3,6,3,12
8,11,5,6,10,9,7,6,11,14,9,6
1,15,4,11,14,3,15,14,10,10,3,12
1,13,5,15,14,11,14,9,12,10,11,6
1,5,4,8,9,13,13,5,4,9,12,8
