12
1,7,7,7,5,6,3,6,0,3,7,6
1,13,13,14,0,11,15,14,3,14,10,8
1,4,2,8,3,14,8,9,14,8,8,0
0,2,10,2,8,10,3,7,13,5,4,0
3,14,9,15,7,12,8,11,7,6,0,2
10,9,6,8,8,3,6,11,12,8,2,8
8,3,15,5,6,11,12,11,7,5,15,6
1,12,11,6,9,13,6,8,9,6,11,12
0,2,11,14,1,4,11,7,7,14,11,6
3,12,9,15,7,6,8,9,14,8,8,10
10,2,1,13,14,10,2,0,10,2,0,8
9,12,0,1,13,13,12,1,13,12,1,4
