12
1,5,7,4,1,6,3,5,7,7,4,2
0,0,11,4,2,9,14,1,14,11,6,8
2,3,12,1,15,7,13,4,8,10,11,4
11,13,5,5,15,13,6,1,4,10,11,4
9,5,6,0,8,1,12,2,1,12,10,2
1,6,10,1,4,3,7,13,5,5,14,8
1,15,12,0,2,9,12,2,1,4,8,0
0,9,6,1,12,3,7,12,3,5,6,2
3,6,11,6,3,12,10,3,15,4,10,10
8,10,9,13,12,1,13,14,8,0,9,14
1,14,1,4,0,1,4,9,6,1,7,12
1,12,1,4,1,5,4,1,12,1,13,4
