12
1,6,3,5,6,2,3,5,6,2,0,2
2,10,8,1,15,12,10,2,9,15,5,12
11,15,6,2,11,5,15,14,0,8,1,4
9,14,10,9,15,7,14,11,5,7,4,2
3,12,10,0,9,13,13,13,7,12,3,12
10,1,12,1,4,3,7,6,11,6,11,6
9,7,4,0,0,9,12,10,11,13,13,14
2,9,6,2,0,0,3,12,10,1,5,12
9,7,14,10,3,5,13,5,13,7,5,6
3,14,8,11,15,5,4,0,3,12,2,8
11,13,7,13,14,0,3,6,11,5,13,4
8,1,12,1,13,4,8,9,12,1,4,0
