12
1,5,6,2,1,5,6,1,7,7,5,6
2,2,10,8,1,5,14,1,13,15,4,10
9,12,10,2,0,1,13,5,4,11,7,14
2,1,15,12,2,0,3,5,4,10,10,8
9,4,9,7,12,1,12,3,7,14,10,0
1,5,5,15,4,3,7,12,11,13,14,2
0,3,7,15,6,9,12,0,8,1,14,10
1,13,13,15,12,1,5,6,1,4,10,8
3,4,1,13,7,5,6,10,2,0,10,2
8,1,6,2,11,6,11,14,10,2,10,10
2,3,13,14,11,15,14,9,15,12,10,10
8,9,4,8,9,13,12,1,13,5,13,12
