12
1,7,5,4,0,1,5,6,1,5,5,6
1,14,1,6,0,3,5,14,2,3,5,12
3,13,5,14,2,10,3,13,12,10,1,6
8,3,6,10,11,15,12,3,6,10,1,14
2,11,13,13,12,9,5,12,9,15,7,12
8,9,7,6,0,3,7,5,6,9,13,4
0,3,13,13,6,9,12,1,13,6,0,2
3,14,3,4,8,0,0,2,3,12,2,8
11,12,10,1,7,7,7,14,9,7,12,0
11,5,12,0,8,10,9,14,1,15,7,4
9,5,5,5,5,12,2,11,7,12,9,4
1,4,1,5,5,4,8,9,13,5,5,4
