12
1,5,7,6,0,3,5,7,6,1,7,6
3,4,11,15,7,12,0,11,12,3,12,10
11,7,12,8,9,6,1,15,4,11,6,8
11,14,2,0,0,10,1,14,2,10,8,2
10,8,8,3,6,9,5,14,9,14,1,14
11,5,4,11,14,3,6,10,0,11,7,14
10,0,0,8,8,11,12,11,6,10,11,12
11,4,3,7,6,9,5,13,14,8,11,4
9,5,14,8,9,5,6,2,10,2,11,4
0,1,12,1,6,2,8,10,9,15,15,6
2,1,7,6,9,12,2,10,3,13,15,14
9,4,9,13,4,0,8,9,13,4,9,12
