12
1,7,6,2,3,6,3,7,5,4,3,6
2,10,11,15,15,15,13,14,0,3,15,14
8,10,10,8,8,11,5,14,3,15,13,14
2,9,13,7,5,14,2,8,11,15,5,14
9,4,1,15,7,13,13,5,14,8,2,8
0,0,0,8,10,3,6,0,10,0,9,6
3,5,6,0,10,9,14,2,9,6,2,8
11,6,10,3,13,6,10,8,1,15,12,0
9,15,13,12,0,8,10,0,0,9,6,0
1,14,3,7,4,0,11,5,6,0,9,6
3,13,13,12,1,5,14,1,15,7,5,12
8,1,4,1,5,4,8,0,9,12,1,4
