12
1,7,5,4,0,1,7,6,1,5,5,6
1,14,1,6,0,3,15,14,2,3,5,12
3,15,5,14,3,15,15,13,12,10,1,6
8,11,6,10,11,15,12,1,7,14,1,14
2,11,13,13,12,9,5,6,9,15,7,12
8,9,7,6,1,7,7,13,6,9,13,6
0,3,15,15,6,9,13,5,13,6,0,10
3,14,11,12,8,0,0,3,7,12,2,8
11,12,10,1,7,7,7,14,9,7,15,4
11,7,14,0,9,14,11,12,3,15,15,6
9,13,13,5,7,13,14,3,15,12,9,14
1,5,5,5,13,4,8,9,13,5,5,12
