12
1,5,5,7,5,6,1,7,4,0,2,0
0,2,2,9,7,15,5,12,0,0,10,0
2,8,8,3,12,8,2,0,0,0,11,6
10,2,1,13,6,2,9,5,4,3,15,14
9,15,5,7,12,9,4,2,0,10,8,10
0,8,1,14,0,3,7,13,5,14,0,10
1,7,4,9,6,9,12,0,2,11,4,8
1,15,6,3,15,5,4,3,14,10,1,6
1,14,8,10,10,0,1,14,8,10,2,10
2,9,5,12,11,7,5,15,5,12,9,14
11,7,6,3,14,9,7,15,7,6,0,8
9,12,8,8,8,0,8,8,8,9,5,4
