12
1,7,5,5,5,5,5,5,5,5,5,6
2,10,3,5,5,5,5,5,5,5,5,12
10,10,9,5,5,5,5,5,5,5,5,6
10,10,3,5,5,5,5,5,5,5,5,12
10,10,9,5,5,5,5,5,5,5,5,6
10,9,5,5,5,7,6,3,5,5,5,12
11,5,5,5,4,9,12,9,5,5,5,6
10,3,5,5,5,5,5,5,5,5,5,12
10,9,5,5,5,5,5,5,5,5,5,6
10,3,5,5,5,5,5,5,5,5,5,12
10,9,5,5,5,5,5,5,5,5,5,6
9,5,5,5,5,5,5,5,5,5,5,12
